##############################
#   #                         
# # # ########################
# # # ########################
# ############################