##############################
#   #    ###    ####        ##
# # # ##     ####### ## ######
# #   ######         ##       
# ############################